@ @ @ 3d 3d @ @ @
@ - - - - - - @
@ - - @ @ - - @
@ - - - - - - @
@ - - - - - @ @
@ @ @ @ @ @ @ @

