@ @ @ @ @ @ @ @ @ @ @ @ @ @ @ @ @ @ @ @ @ @ @ @ @ @ @ @ @ @ @ @ @ @
@ - - - - - - - - - - - - - - - - - - - - - - - - - - - - - - - - @
@ - - - - - - - - - - - - - @ @ @ @ @ @ - - - - - - - - - - - - - @
@ - - - - - - - - - - - - - - - - - - - - - - - - - - - - - - - - @
@ - - - - - - - - - - - - - - - - - - - - - - - - - - - - - - - - @
@ - - - - - - - - - - @ - - - - - - - - - - @ - - - - - - - - - - @
@ @ - - - - - - - - - - - - @ - - - - @ - - - - - - - - - - - - @ @
9r - - - - - - - - - - - - - - - @ @ - - - - - - - - - - - - - - - @
9r - - - - - - - - - - - - - - - - - - - - - - - - - - - - - - - - @
9r - - - - - - - - - - - - - - - - - - - - - - - - - - - - - - - - @
9r - - - - - @ - - - - - - - - @ - - @ - - - - - - - - @ - - - - - @
@ @ @ - - - - - - - - - - - - - - - - - - - - - - - - - - - - - @ @
@ - - @ - - - @ - - @ @ @ - @ - - - - - - - - @ - - - - - - - - - @
@ - - - @ - - @ - - @ - @ - @ - - - - - - - - - - - - - - - - - - @
@ - @ - - @ - @ @ - @ @ @ - @ @ - - - - - - - - - - - - - - - @ - @
@ - - - - @ - - - - - - - - - - - - - - - - - - - - - - - - - - - @
@ - - - - - @ @ @ - - - - - - - - - - - - - - - - - - - - - - - - @
@ @ @ @ @ @ @ @ @ @ @ @ @ @ @ 7u 7u 7u 7u @ @ @ @ @ @ @ @ @ @ @ @ @ @ @