@ @ @ @ @ @ @ @ @ @ @ @ @ @ @ 5d 5d 5d 5d @ @ @ @ @ @ @ @ @ @ @ @ @ @ @
@ - @ - - - - - - - - - - - - - - - - - - - - - - - - - - - - - - @
@ - @ - - - @ @ @ @ - - - - - @ @ @ @ @ @ - - - @ @ @ @ - - - - - @
@ - - - - - - - - - - - - - - - - - - - - - - - - - - - - - - - - @
@ - @ @ @ @ @ @ @ @ @ @ @ @ @ @ @ @ @ @ @ @ @ @ @ @ @ @ @ @ @ @ @ @
@ - - - - - - - - - - - - - - - - - - - - - - - - - - - - - - - - @
@ @ @ @ @ - - - - - - - - - - - - - - - - - - - - - - - - - - @ @ @
@ - - - - - - - - - - - - - - - - - - - - - - - - - - - - - - - - 3l
@ - - - - - @ @ @ @ - - - - - - - - - - - - - - - - - - - - - - - 3l
@ - - - - - - - - - - - - - - - - - - - - - - - - - - - - - - - - 3l
@ @ @ @ @ - - - - - - - - - - - - - - - - - - - - - - - - - - - - 3l
@ - - - - - - - - - - - - - - - - - - - - - - - - - - - - - - @ @ @
@ - - - - - @ @ @ @ - - - - - - - - - - - - - - - - - - - - - - - @
@ - - - - - - - - - - - - - - - - - - - - - - - - - @ @ @ @ - - - @
@ @ @ @ @ - - - - - - - - - - - - - - - - @ @ @ @ - - - - - - - - @
@ - - - - - - - - - - - - - - - @ @ @ @ - - - - - - - - - - - - - @
@ - - - - - - - - - - - - - - - - - - - - - - - - - - - - - - - - @
@ @ @ @ @ @ @ @ @ @ @ @ @ @ @ @ @ @ @ @ @ @ @ @ @ @ @ @ @ @ @ @ @ @