@ @ @ @ @ @ @ @ @ @ @ @ @ @ @ 7d 7d 7d 7d @ @ @ @ @ @ @ @ @ @ @ @ @ @ @
@ - - - - - - - - - - - - - - - - - - - - - - - - - - - - - - - - @
@ - - - - - - - - - - - @ - @ @ @ @ @ @ - - - - - - - - - - - - - @
@ - - - - - - - - - @ - - - - - - - - - - - - - - - - - - - - - - @
@ - - - - - - - - - - - - - - - - - - - - - - - - - - - - - - - - @
@ - - - - - - - @ - - @ - - - - - - - - - - @ - - - - - - - - - - @
@ @ - - - - - @ - - - - - - @ - - - - @ - - - - - - - - - - - - @ @
3r - - - @ - @ - - - - - - - - - @ @ - - - - - - - - - - - - - - - @
3r - - @ @ @ @ - - - - - - - - - - - - - - - - - - - - - - - - - - @
3r - @ - - - @ - - - - - - - - - - - - - - - - - - - - - - - - - - @
3r - - - - @ @ - - - - - - - - @ - - @ - - - - - - - - @ - - - - - @
@ @ @ - - - - - - - - - - - - - - - - - - - - - - - - - - - - - @ @
@ - - @ - - - @ - - @ @ @ - @ - - - - - - - - @ - - - - - - - - - @
@ - - - @ - - @ - - @ - @ - @ - - - - - - - - - - - - - - - - - - @
@ - @ - - @ - @ @ - @ @ @ - @ @ - - - - - - - - - - - - - - - @ - @
@ - - - - @ - - - - - - - - - - - - - - - - - - - - - - - - - - - @
@ - - - - - @ @ @ - - - - - - - - - - - - - - - - - - - - - - - - @
@ @ @ @ @ @ @ @ @ @ @ @ @ @ @ @ @ @ @ @ @ @ @ @ @ @ @ @ @ @ @ @ @ @