@ @ @ @ @ @ @ @ @ @ @ @ @ @ @ 8d 8d 8d 8d @ @ @ @ @ @ @ @ @ @ @ @ @ @ @
@ - - - - - - - - - - - - - - - - - - - - - - - - - - - - - - - - @
@ - - @ @ @ @ @ @ @ @ @ @ @ @ @ @ @ @ @ @ @ @ @ @ @ @ @ @ @ @ - - @
@ - - - - - - - - - - - - - - - - - - - - - - @ - - - - - - - - @ @
@ @ - - - - - - - - - - - - - - - - - - - - - @ - - - - - - @ - - @
@ - - - - - - - - - - - @ - - - - - - - - - - @ - - - @ - - - - - @
@ - @ - - - - - - - - - @ - - @ @ @ @ @ @ - - @ - - - - - - - - @ @
@ - - - - - - - - - @ @ @ - - - - - - - - - - @ - - @ @ @ @ - - - 6l
@ - - @ - - - - - - - - @ @ - - - - - - - - @ @ - - - - - - - - - 6l
@ - - - - - - - @ @ @ @ @ - - - - - - - - - - @ - - - - - - - - - 6l
@ - @ - - - - - - - - - @ - - @ @ @ @ @ @ - - @ @ @ @ @ @ @ @ @ @ @
@ - - - - - - @ @ @ @ - @ - - - - - - - - - - @ @ @ @ @ @ @ @ @ @ @
@ @ - - - - - - - - - - @ @ - - - - - - - - @ @ @ @ @ @ @ @ @ @ @ @
@ - - - - @ @ @ @ - - - @ - - - - - - - - - - @ @ @ @ @ @ @ @ @ @ @
@ - - - - - - - - - - - @ - - @ @ @ @ @ @ - - @ @ @ @ @ @ @ @ @ @ @
@ - - - - - - - - - - - @ - - - - - - - - - - @ @ @ @ @ @ @ @ @ @ @
@ - - - - - - - - - - - - - - - - - - - - - - @ @ @ @ @ @ @ @ @ @ @
@ @ @ @ @ @ @ @ @ @ @ @ @ @ @ 2u 2u 2u 2u @ @ @ @ @ @ @ @ @ @ @ @ @ @ @