@ @ @ @ @ @ @ @ @ @ @ @ @ @ @ 10d 10d 10d 10d @ @ @ @ @ @ @ @ @ @ @ @ @ @ @
@ - - - - - - - - - - - - - - - - - - - - - - - - - - - - - - - - @
@ - - @ @ @ @ @ @ @ @ @ @ @ @ @ @ @ @ @ @ @ @ @ @ @ @ @ @ @ @ - - @
@ - - - - - - - - - - - - - - - - - - - - - - - - - - - - - - - - @
@ - @ - - - - - - - - - - - - - - - - - - - - - - - - - - - - @ - @
@ - - - - - - - - - - @ - - - - - - - - - - @ - - - - - - - - - - @
@ @ - - - - - - - - - - - - @ - - - - @ - - - - - - - - - - - - @ @
6r - - - - - - - @ @ @ - - - - - @ @ - - - - - - - - - - - - - - - @
6r - @ - - - - - - - - - - - - - - - - - - - - - - - - - - - - @ - @
6r - - - - - - - - - - - - - - - - - - - - - - - - - - - - - - - - @
@ @ - - - - @ - - - - - - - - @ - - @ - - - - - - - - @ - - - - @ @
@ @ @ - - - - - - - - - - - - - - - - - - - - - - - - - - - - @ @ @
@ - - @ - - - - @ - @ @ @ - @ - @ - - - @ @ - @ - - - - - @ @ - - @
@ - - - @ - - @ - @ @ - @ - - @ - - - - - @ - - - - - @ @ - - - - @
@ - @ - - @ - @ - @ @ @ @ - @ - @ - - - @ - - - - @ @ - - - - @ - @
@ - - - - @ - - - - - - - - - - - - - - - - - @ @ - - - - - - - - @
@ - - - - - @ @ @ - - - - - - - - - - - - - @ - - - - - - - - - - @
@ @ @ @ @ @ @ @ @ @ @ @ @ @ @ 4u 4u 4u 4u @ @ @ @ @ @ @ @ @ @ @ @ @ @ @