@ @ @ @ @ @ @ @ @ @ @ @ @ @ @ @ @ @ @ @ @ @ @ @ @ @ @ @ @ @ @ @ @ @
@ - - - - - - - - - - - - - - - - - - - - - - - - - - - - - - - - @
@ - - - - - @ @ @ @ - @ @ @ @ - @ @ @ @ - - @ @ @ @ @ @ @ @ @ @ - @
@ - - - - - - - - - - - - - - - - - - - - - - @ - - - - - - - - - @
@ - @ @ @ @ - - - - - - - - - - - - - - - - - @ - - - @ @ @ @ @ @ @
@ - - - - - - - - - - - - - - - - - - - - - - @ @ @ - @ @ @ @ @ @ @
@ @ @ @ @ @ @ @ @ @ @ @ @ @ @ @ @ @ @ @ @ @ - @ - - - @ - - - - @ @
@ - - - - - - - - - - - - - - - - - - - - - - @ - @ @ @ - - - - - 9l
@ - - - @ @ @ @ - - - - - - - - - @ @ @ @ - @ @ - - - @ @ - - @ - 9l
@ - - - - - - - - - @ @ @ @ - - - - - - - - - @ @ @ - @ - - - @ - 9l
@ - - - @ @ @ @ - - - - - - - - - @ @ @ @ - - @ - - - @ - - - @ - 9l
@ - - - - - - - - - - - - - - - - - - - - - - @ - @ @ @ - @ - @ @ @
@ - @ @ @ @ @ @ @ @ @ @ @ @ @ @ @ @ @ @ @ @ @ @ - - - @ - - - - - @
@ - - - - - - - - - - - - - - - - - - - - - - @ @ @ - @ - - - - - @
@ @ @ @ @ - - - - - - - - - - - - - - - - - - @ - - - @ @ - - - - @
@ - - - - - - @ @ @ @ - - - - - @ @ @ @ - - - @ - @ @ @ - - - - @ @
@ - - - - - - - - - - - - - - - - - - - - - - @ - - - - - - - - - @
@ @ @ @ @ @ @ @ @ @ @ @ @ @ @ 5u 5u 5u 5u @ @ @ @ @ @ @ @ @ @ @ @ @ @ @