@ @ @ @ @ @ @ @ @ @ @ @ @ @ @ @ @ @ @ @ @ @ @ @ @ @ @ @ @ @ @ @
@ - - - - - - - - - - - - - - @ @ - - - - - - - - - - - - - - @
@ - - - - - - @ @ - - - - - - @ @ - - - - - - @ @ - - - - - - @
@ - - - @ @ - - - - @ @ - - - - - - - - @ @ - - - - @ @ - - - @
@ - - - - - - - - - - - - - - - - - - - - - - - - - - - - - - @
@ - @ @ - - - - - - - - @ @ - @ @ - @ @ - - - - - - - - @ @ - @
@ - - - - - - - - - - - - - - @ @ - - - - - - - - - - - - - - @
@ - - - - - - - - - - - - - - @ @ - - - - - - - - - - - - - - @
@ @ @ @ @ @ - - - - @ @ @ @ @ @ @ @ @ @ @ @ - - - - @ @ @ @ @ @
@ @ @ @ @ @ @ - - @ @ @ @ @ @ @ @ @ @ @ @ @ @ - - @ @ @ @ @ @ @
@ - - - - - - - - - - - - - - @ @ - - - - - - - - - - - - - - @
@ - - - - - - @ @ - - - - - - @ @ - - - - - - @ @ - - - - - - @
@ - - - @ @ - - - - @ @ - - - - - - - - @ @ - - - - @ @ - - - @
@ - - - - - - - - - - - - - - - - - - - - - - - - - - - - - - @
@ - @ @ - - - - - - - - @ @ - @ @ - @ @ - - - - - - - - @ @ - @
@ - - - - - - - - - - - - - - @ @ - - - - - - - - - - - - - - @
@ - - - - - - - - - - - - - - @ @ - - - - - - - - - - - - - - @
@ @ @ @ @ @ @ @ @ @ @ @ @ @ @ @ @ @ @ @ @ @ @ @ @ @ @ @ @ @ @ @