@ @ @ @ @ @ @ @ @ @ @ @ @ @ @ @ @ @ @ @ @ @ @ @ @ @ @ @ @ @ @ @ @ @
@ - - - - - - - - - - - - - - @ @ - - - - - - - - - - - - - - - - @
@ - - - - - - @ @ - - - - - - @ @ - - - - - - @ @ - - - - - - @ - @
@ - - - @ @ - - - - @ @ - - - - - - - - @ @ - - - - @ @ - - - @ - @
@ - - - - - - - - - - - - - - - - - - - - - - - - - - - - - - @ - @
@ - @ @ - - - - - - - - @ @ - @ @ - @ @ - - - - - - - - @ @ - @ - @
@ - - - - - - - - - - - - - - @ @ - - - - - - - - - - - - - - @ - @
@ - - - - - - - - - - - - - - @ @ - - - - - - - - - - - - - - @ - @
@ @ @ @ @ @ - - - - @ @ @ @ @ @ @ @ @ @ @ @ - - - - @ @ @ @ @ @ - @
@ @ @ @ @ @ @ - - @ @ @ @ @ @ @ @ @ @ @ @ @ @ - - @ @ @ @ @ @ @ - @
@ - - - - - - - - - - - - - - @ @ - - - - - - - - - - - - - - @ - @
@ - - - - - - @ @ - - - - - - @ @ - - - - - - @ @ - - - - - - @ - @
@ - - - @ @ - - - - @ @ - - - - - - - - @ @ - - - - @ @ - - - - - @
@ - - - - - - - - - - - - - - - - - - - - - - - - - - - - - - @ - @
@ - @ @ - - - - - - - - @ @ - @ @ - @ @ - - - - - - - - @ @ - @ - @
@ - - - - - - - - - - - - - - @ @ - - - - - - - - - - - - - - @ - @
@ - - - - - - - - - - - - - - @ @ - - - - - - - - - - - - - - @ - @
@ @ @ @ @ @ @ @ @ @ @ @ @ @ @ @ @ @ @ @ @ @ @ @ @ @ @ @ @ @ @ @ @ @